so paulo - the weeknd [edit audio]
if we being ral (tiktok version) - yeat [edit audio]
no fear! x matushka ultrafunk (brazilian phonk) - satirin x andromeda [edit audio]
mala (tiktok version) - 6ix9ine [edit audio]
eternal peace - goldkid$, tbt prod. [edit audio]
i wanna watch boys to - lana del rey, arctic monkeys [edit audio]
two (that's left, right, left, right) - bbno$ [edit audio]
камин (tiktok version/best part!) - emin feat. jony [edit audio]
lya funk (slowed) - vj & trvnsporter [edit audio]
slava funk! (slowed/tiktok version) - mvsterious [edit audio]
village funk! - bear bear & friends, mvsterious [edit audio]
nunca muda? - scythermane, nxght! [edit audio]
empty space - goldkid$, tbt prod. [edit audio]
funk with me - goldkid$, ya boi ivan, wxrmane [edit audio]
mortals funk (slowed) - lxngvx, warriyo [edit audio]
funk sentimento - vxca [edit audio]
kush - spitty ft. sonaali [edit audio]
2 phut hon funk (inst. version/tiktok remix) - mgd [edit audio]
timeless (guitar remix) - the weeknd, playboi carti [edit audio]
bloody marry. - sepulcher., goldkid$ [edit audio]
mortals funk (tiktok version) - lxngvx, warriyo [edit audio]
menina do job x viciada em sentar (slowed/tiktok version) - mac xangai e mc th [edit audio]
blue horizon funk (slowed/tiktok version) - nxght! [edit audio]
2 phut hon funk (slowed to perfection/tiktok version) - mgd [edit audio]
kompa parano (tiktok version) - frozy [edit audio]
2 phut hon funk (tiktok version/best part!) - mgd [edit audio]
bloody! (ultra slowed) - m4gn [edit audio]
after dark x heavenly - navjaxx, goldkid$ x mr.kitty [edit audio]
one of the girls x good for you - the weeknd, jennie & lily-rose depp x selena gomez [edit audio]
love potions (slowed/tiktok version) - bj lips feat. princess paparazzi [edit audio]
x-tali (slide funk) - mxccree [edit audio]
funk infernal (slowed) - dygo & mxng0 [edit audio]
new jeans (jersey club remix/tiktok version) - jiandro x dxrkaii [edit audio]
mingle game funk - seraphix, goldkid$ [edit audio]
slava funk! - mvsterious [edit audio]
505 - laranesoul [edit audio]
i'm good (blue) - david guetta & bebe rexha [edit audio]
and with that the 2024 season comes to an end x end of beginning - djo [edit audio]
leave the door open - i'm dru! [edit audio]
gata only (tiktok version/best part!) - floyymenor ft. cris mj [edit audio]
let him cook (tiktok remix) - xnimxs [edit audio]
sleigh bells (remix) - ronettes [edit audio]
heavenly - navjaxx, goldkid$ [edit audio]
jesus (brazilian phonk) - ogryzek [edit audio]
blue x frieren (tiktok version/best part!) - yung kai [edit audio]
subway surfers funk - dj portu [edit audio]
willy wishbone - cody lawless ft. elijah blond [edit audio]
spartan funk! - wharoxmane, goldkid$, tbt prod., evo [edit audio]
matushka ultrafunk - satirin, funk demon, evo [edit audio]
funk infernal - dygo & mxng0 [edit audio]
death bed pt 2 - powfu [edit audio]
don't stop (slowed) - glxxmstrider [edit audio]
love for you (tiktok remix) - loveli lori & ovg! [edit audio]
2 phut hon funk (slowed) - mgd [edit audio]
funk do bounce (slowed) - ariis [edit audio]
top of the world - sol.luna [edit audio]
darling (afrobeat instrumental) - leokarlo [edit audio]
something going on (slowed to perfection) - kaysha [edit audio]
die with a smile (tiktok version/best part!) - lady gaga, bruno mars [edit audio]
kingdom (brazilian phonk) - ogryzek [edit audio]
ku lo sa (tiktok version/best part!) - oxlade [edit audio]
judas (tiktok version/best part!) - lady gaga [edit audio]
low life (sniper sniper wifey wifey) - future ft. the weeknd [edit audio]
spooky x burnice zzz (tiktok remix) - fennecxx, dj alex [edit audio]
ultra vuk (brazilian funk) - trashxrl [edit audio]
hero! (brazilian phonk) - andromeda [edit audio]
we don't talk anymore (tiktok version) - charlie puth ft. selena gomez [edit audio]
corazn - rarin [edit audio]
STAYWITHME# - GOLDKID$ [edit audio]
die with a smile "If the world was ending" - lady gaga, bruno mars [edit audio]
FSHION - britney manson [edit audio]
empire (brazilian phonk) - ogryzek [edit audio] [edit audio]
yad (inst. version + backing vocals) - erika lundmoen [edit audio]
gameplay funk x keygen funk - prey x andromeda [edit audio]
right now (best part) -  one direction [edit audio]
no fear! x next! (brazilian phonk) -  andromeda, kvrxd x ncts [edit audio]
no fear! (brazilian phonk) -  andromeda, kvrxd [edit audio]
loveshots! - xanakin skywok [edit audio]
life force (tiktok remix) - rj pasin, ptasinski [edit audio]
death rattle (slowed) - miguel angeles [edit audio]
x-tali x void - mxccree & dj gl3cheky x isq [edit audio]
hurts so good (slowed to perfection) - astrid s [edit audio]
2 phut hon funk - mgd [edit audio]
get me right - he4t [edit audio]
cowboy - kam prada [edit audio]
fluxxwave (slowed to perfection) - clovis reyes [edit audio]
apt. - rose & bruno mars [edit audio]
gata only x lost soul - floyymenor ft cris mj x nbsplv [edit audio]
collide - justine skye ft. tyga [edit audio]
all the stars (slowed to perfection) - kendrick lamar, sza [edit audio]
habits (slowed to perfection) - mr.kitty [edit audio]
dare (brazilian phonk) x you're mine | camellya - sayfalse, trxveler, dj alim [edit audio]
me and the devil - soap&skin [edit audio]
not my problem x let me in (meme edit) - laila! x kanii [edit audio]
let the world burn (tiktok version) - chris grey, g-eazy & ari abdul [edit audio]
darkside - neoni [edit audio]
why don't we - 8 letters [edit audio]
#brooklynbloodpop! (instrumental ver.) - syko [edit audio]
funk do bounce (tiktok version) - ariis [edit audio]
automotivo amar, ma ma ma - bibi babydoll [edit audio]
gata only (slowed to perfection) - floyymenor ft. cris mj [edit audio]
let him cook x imperius (tiktok remix) - playboi carti [edit audio]
tore up (c/w @itsshadowedits) - don toliver [edit audio]
not my problem x whine in brazil - dj zrx [edit audio]
void (microwave trending) - isq [edit audio]
forget my ex - rarin [edit audio]
x-prime (brazilian phonk) - dj samir [edit audio]
alibi la rose! (bemax phonk remix) - sevdaliza [edit audio]
камин - emin feat. jony [edit audio]
roi (instrumental) - videoclub [edit audio]
hypnotic (tiktok remix) - isq [edit audio]
alibi (rosa que linda eres) - sevdaliza [edit audio]
bloody mary (best part) - lady gaga [edit audio]
bye bye bye - *nsync [edit audio]
est-ce que tu m'aimes? (spedup) - matre gims [edit audio]
mortals (best part) - warriyo feat. laura brehm [edit audio]
bero 00 (ultra slowed) - anar [edit audio]
i like the way you kiss me (guitar remix) - artemas [edit audio]
keep up - odetari [edit audio]
funk universo (slowed) - irokz [edit audio]
beeper funk (slowed) - dj paulinho mondi [edit audio]
not my problem (jersey club remix) - laila! [edit audio]
whine in brazil (i ain't got my eye on you) - ichiss [edit audio]
forever young (climax ver.) - alphaville [edit audio]
smoke it off! (guitar remix) - lumi athena [edit audio]
"Let's Go Gambling" x X-Slide (tiktok remix) - 2ke, 808iuli [edit audio]
glory (brazilian phonk) - ogryzek [edit audio]
the machine (sped up) - reed wonder, aurora olivas [edit audio]
tell me how! (tell me girl) - bxiety [edit audio]
avangard (brazilian phonk) - lonown [edit audio]
funk universo x soka mona (gojo voice) - irokz [edit audio]
next! (brazilian phonk) - ncts [edit audio]
i found you | tiktok remix (unforgettable) - pnb rock remix [edit audio]
glory of aura (brazilian phonk) - ogryzek [edit audio]
mamacita (sped up) - rarin [edit audio]
aura (brazilian phonk) - ogryzek [edit audio]
gata only (tiktok remix) - floyymenor ft. cris mj [edit audio]
bludlust - daegho & ngxt [edit audio]
big dawgs (i'm a big stepper underground methods) - hanumankind ft. kalmi [edit audio]
mamacita - rarin [edit audio]
what would you know about me? x flare - hensonn [edit audio]
next up! (brazilian phonk) - ncts [edit audio]
stargazer - chashkakefira, vxnt1k [edit audio]
something going on (sped up) - kaysha [edit audio]
re-up - peak [edit audio]
smackdown - he4t [edit audio]
keygen funk (why so serious?) - prey [edit audio]
her love - rarin [edit audio]
alibi - sevdaliza ft. pabllo vittar & yseult [edit audio]
for you - he4t [edit audio]
should've known - unbnd [edit audio]
woo x i was never there (tiktok version) - the weeknd & rihanna [edit audio]
x-slide - 808iuli, 2ke [edit audio]
stuck next to you - tiishe [edit audio]
million dollar baby - tommy richman [edit audio]
pharaoh! (brazilian phonk) - eternxlkz [edit audio]
let me down - rory travelle [edit audio]
espresso - sabrina carpenter [edit audio]
mtg pancada ritmado (brazilian phonk) - manlikefdot [edit audio]
gwap - zvch [edit audio]
montagem jumpstyle (brazilian funk) - hussain ali [edit audio]
bullseye - icey ak feat. rarin [edit audio]
slay! x enough! (brazilian phonk) - eternxlkz [edit audio]
pocot x nah i'd win - offl1nx [edit audio]
diamond eyes - shea michael & tinywiings [edit audio]
power! (brazilian phonk) - mrl [edit audio]
i like the way you kiss me x the perfect girl -  artemas, mareux [edit audio]
montagem rave eterno (brazilian funk) - dj samir [edit audio]
never tell - luke chiang [edit audio]
call me girl - rarin [edit audio]
bunny girl Brazil - djzrx [edit audio]
kompa x gata only - floyymentor x frozy [edit audio]
fainted - narvent [edit audio]
lost soul down x russian (floki/tiktok remix) [edit audio]
kompa (don't copy my flow) - frozy [edit audio]
kompa (she said she's love the islands) - rarin x frozy [edit audio]
on the floor (brazilian phonk) - kverz [edit audio]
funked up (glitch version) - xxanteria, isq [edit audio]
eu sento gabu! - pxlwyse [edit audio]
infinity funk - prey [edit audio]
end - lowx [edit audio]
*H+3+яƒ*7luCJIo0T6... - vyrval [edit audio]
dress! (brazilian phonk) - eternxlkz [edit audio]
one more ride - nyukyung [edit audio]
masha ultrafunk - histed, txvsterplaya [edit audio]
ha-ha! - forgottenage [edit audio]
let the world burn (tiktok remix) - chris grey [edit audio]
icewhore - lumi athena [edit audio]
funk of galctico - sxid [edit audio]
unforgettable (i found you girl i like being around you) pnb rock remix [edit audio]
kompa (she said shes love the islands) - rarin [edit audio]
destroy! - souly had [edit audio]
bangmychest! - headband andy [edit audio]
bloody brazil - tenzoo [edit audio]
death no more - blessed mane [edit audio]
kompa jersey (irokz remix) - frozy [edit audio]
heartburn - tenseoh [edit audio]
montagem invaso - arxmane [edit audio]
way down we go (inst/guitar) - kaleo [edit audio]
cute depressed - dyan dxddy [edit audio]
consume - chase atlantic [edit audio]
tokyo (nya! arigato) - leat'eq [edit audio]
duvet - ba [edit audio]
alien flame - shometyle [edit audio]
2000 - vowl. & sace [edit audio]
nightcrawler (instrumental) - travis scott [edit audio]
floki & lost soul remix [edit audio]
ecstacy - suicidal-idol [edit audio]
run that - xanakin skywok [edit audio]
i'm toxic - khantrast [edit audio]
prince of egypt - mofe. [edit audio]
one call - rich amiri [edit audio]
500lbs - lil tecca [edit audio]
pricey (talk to me nicely) - kam prada [edit audio]
slay! - eternxlkz [edit audio]
one of the girls x streets x white mustang [edit audio]
greedy (i would want myself) - tate mcrae [edit audio]
amor em deus (brazilian phonk) - nxvamane [edit audio]
tadow (i saw her and she hit me like tadow) - masego & fkj [edit audio]
dentro de voc (brazilian phonk) - rxdxvil, laq1zen [edit audio]
montagem cocota (brazilian phonk) - jolixwery & dj la [edit audio]
satisfaction (push push push) - benny benassi [edit audio]
love on me x prince of egypt - jtbazz x mofe. [edit audio]
montagem mysterious game - lxngvx [edit audio]
eeyuh! x fluxxwave (tiktok mashup) - hr x clovis reyes [edit audio]
dna (brazilian phonk) - Ixngvx, visxge [edit audio]
montagem diamante rosa - vtze [edit audio]
macho! - xanakin netwok [edit audio]
light's theme (rude remix) [edit audio]
something going on - kaysha [edit audio]
mami! - xanakin skywok [edit audio]
krushed! - $werve, fxrce & sxcredmane [edit audio]
ladykiller! - xanakin skywok [edit audio]
treinamento de fora (slowed) - trxveler [edit audio]
baixo x yummi (tiktok mashup) - xxanteria, lxngvx [edit audio]
cleared (tiktok remix) - lilithzplugz [edit audio]
enough (brazilian phonk) - eternxlkz [edit audio]
ashi ashi dana phonk (tiktok remix) - dj splin [edit audio]
fluxxwave x shameless - clovis reyes x camila cabello [edit audio]
flawless 2 (prod. sky) - yeat ft. lil uzi vert [edit audio]
#brooklynbloodpop! x dead inside - адлин x syko [edit audio]
rack love - rarin [edit audio]
funk of suffering (brazilian phonk) - sxid [edit audio]
funked up - xxanteria, isq [edit audio]
bad feeling (oompa loompa) - jagwar twin [edit audio]
resonance x memory reboot - home x vj, narvent [edit audio]
escapism (i don't wanna feel) - raye ft. 070 shake [edit audio]
sleepwalker x icewhore - akiaura x lumi athena [edit audio]
senpai - shiki [edit audio]
untitled #13 (slowed) - glwzbll [edit audio]
love on me - jtbazz [edit audio]
below the surface (instrumental) - griffinilla [edit audio]
on the floor - removeface, lumi athena [edit audio]
lovely bastards - zwe1hvndxr & yatashigang [edit audio]
big boy (guitar remix) - sza [edit audio]
bloodline x pony (tiktok remix) - ariana grande & ginuwine [edit audio]
positions - ariana grande [edit audio
eeyuh (irokz remix) - hr [edit audio]
sleepwalker (phonk remix) - akiaura [edit audio]
i'll do it x metamorphosis (phonk remix) - heidi montag x interworld [edit audio]
one of the girls - the weeknd, jennie & lily rose depp [edit audio]
give it to me (instrumental) - timbaland [edit audio]
brodyaga funk - eternxlkz [edit audio]
agora hills (i wanna show you off) - doja cat [edit audio]
popular - the weeknd, playboi carti, madonna [edit audio]
manda bala - ariis [edit audio]
shinunoga e-wa (violin remix) - fujii kaze [edit audio]
luminary - joel sunny [edit audio]
my marmalade (мой мармеладный) - katya lel [edit audio]
jingle bells phonk - aega [edit audio]
chipi chipi chapa chapa dubi dubi daba daba (dubidubidu) -  christell [edit audio]
sleepwalker x death is no more - akiaura, blessed mane [edit audio]
aku sayang x sprinter - kirkiimad [edit audio]
skyfall (where you go, i go) - adele [extended edit audio]
fashion - britney manson [edit audio]
where you go (skyfall) - adele [edit audio]
skyfall (where you go, i go) - adele [edit audio]
diamondz n roses - vaporgod [edit audio]
mtg ensurdecncia estelar 1.0 - dj frest [edit audio]
mtg pega la - dj fku [edit audio]
fluxxwave (remix) - clovis reyes [edit audio]
funk of the damned - sxid [edit audio]
indian phonk eki - nueki [edit audio]
sleepwalker (guitar remix) - akiaura [edit audio]
ritmo brutalismo (brazilian funk) - xllie! [edit audio]
mtg maldio eterna 1.0 - dj glk [edit audio]
toma toma (brazilian phonk) - tigmus [edit audio]
coqueta (brazilian phonk) - slxughter [edit audio]
black swan (orchestral instrumental) - bts [edit audio]
ningum vai me derrotar - dj fku [edit audio]
after dark (violin remix) - mr.kitty [edit audio]
rio rave - tokyosleep [edit audio]
rei do brasil - seek [edit audio]
ritmo de treino - youthisending [edit audio]
ultraphunk - crazy mano, dashie & isxro [edit audio]
beat distorce pancada 1.0 - dj wlk [edit audio]
the autotrem 1.0 - dj rick 013 [edit audio]
untitled #13 - glwzbll [edit audio]
montagem coral - dj holanda [edit audio]
the automotivo infernal 1.0 (purple) - mrl [edit audio]
yummi (tiktok version) - lxngvx [edit audio]
baixo - xxanteria [edit audio]
don't surrender - egzod & emm [edit audio]
tuca donka - cursedevil [edit audio]
heroes tonight - janji feat. johnning [edit audio]
trienamento de fora - trxveler [edit audio]
on & on - cartoon ft. daniel levi [edit audio]
cardigan (tiktok version) - taylor swift [edit audio]
umbrella (skeler remix) - rihanna (ember island cover) [edit audio]
automotivo bibi fogosa - bibi babydoll & dj brunin xm [edit audio]
i'm blue (trap remix) - eiffel 65 [edit audio]
talk (baby i got issues but i love myself) - salvatore ganacci [edit audio]
wat u want 2 (prod. sky) - yeat [edit audio]
no rival - egzod, maestro chives & alaina cross [edit audio]
le monde (tiktok version) - richard carter [edit audio]
lost soul down x ecstacy - suicidal-idol x nbsplv [edit audio]
the box (guitar remix) - roddy ricch [edit audio]
shadows - pastel ghost [edit audio]
past lives - sapientdream [edit audio ]
memory reboot - vj, narvent [edit audio]
mortals - warriyo ft. lauren brehm [edit audio]
too many nights - metro boomin [edit audio]
paint the town red - doja cat [edit audio]
royalty - egzod & maestro chives ft. neoni [edit audio]
yad (slowed) - erika lundmoen [edit audio]
reflections (tiktok remix) - the neighbourhood [edit audio]
ku lo sa - oxlade, camila cabello [edit audio]
the hills x idol - the weeknd x yoasobi [edit audio]
bloody mary - instrumental (slowed + reverb) lady gaga [edit audio]
the lost soul down (slowed + reverb) guitar remix - nbsplv [edit audio]
one chance (slowed + reverb) - interworld x moondeity [edit audio]
montagem orquestra sinfnica (slowed) - dj tenebroso [edit audio]
fluxxwave (lay with me) - clovis reyes & the dive [edit audio]
moonlight - kali uchis [edit audio]
dznum (moje more) - teya dora [edit audio]
close eyes (among us remix) - dvrst [edit audio]
sleepwalker - akiaura [edit audio]
trance - metro boomin [edit audio]
ayo girl - jason derulo & robinson [edit audio]
wine pon you x little dark age [edit audio]
I wanna be yours x summertime sadness - arctic monkeys, lana del rey [edit audio]
i wanna be yours (instrumental) - arctic monkeys [edit audio]
little dark age x washing machine heart [edit audio]
fresh - nxvamane [edit audio]
government hooker - lady gaga (doonik remix) - [edit audio]
you look lonely, i can fix that x memory reboot [edit audio]
after dark x memory reboot [edit audio]
go gyal - ahzee [edit audio]
smoke it off! - lumi athena x jnhygs [edit audio]
girls like me don't cry (spedup) - thuy [edit audio]
cheques - shubh [edit audio]
starboy - the weeknd [edit audio like @XenozEdit]
after dark (phonk remix) [edit audio]
yad (€д) english version [edit audio]
empathy - crystal castles [edit audio]
look don't touch - odetari & carde clair [edit audio]
brazilian dana phonk - 6ynthmane [edit audio]
sequncia da dz7 (funk br) - trashxrl [edit audio]
faded x alone pt. ll [edit audio]
infected (slowed + reverb) - sickick [edit audio]
keygen.exe - siouxxie [edit audio]
beethoven classical phonk remix [edit audio]
the lost soul down x lost soul [edit audio]
fluxxwave (tiktok version) - clovis reyes [edit audio]
orquestra maldita - trashxrl [edit audio]
montagem - pr funk (ashley! look at me) [edit audio]
money trees - kendrick lamar ft. jay rock [edit audio]
cataclysm ("I'm stronger, I'm smarter.. I'm better!") - yvetzal [edit audio]
lost soul down (tiktok version) - nbsplv [edit audio]
montagem - pr funk (brazilian funk) - s3bzs [edit audio]
I Know - Kanii [edit audio]
montagem amedrontadora - dj wizard [edit audio]
royalty (slowed) - egzod & maestro chives ft. neoni [edit audio]
shadow lady x metamorphosis | phonk tiktok mashup [edit audio]
own paradise - lxaes [edit audio]
thrift shop (instrumental) - macklemore & ryan lewis ft. wanz [edit audio]
daylight - david kushner [edit audio]
I'll do it (instrumental) - ayesha erotica [edit audio]
отключаю телефон (turn off the phone) - instasamka [Edit Audio]
way down we go (instrumental) - kaleo [edit audio]
redchinawave - отмен€й [edit audio]
yad - erika lundmoen [edit audio]
incoming - mc orsen [edit audio]
metamorphosis 3 x close eyes - interworld x dvrst [edit audio]
neon blade (ravens rock version) - moondeity [edit audio]
phonk up brazil - $werve [edit audio]
desperate - neffex x ncs [edit audio]
sea of problems - glichery [edit audio]
drunk-dazed - enhypen [edit audio]
she knows - ne-yo ft. juicy j [edit audio]
bumble bee - bambee [Edit Audio]
golden hour - jvke [edit audio]
cupid (twin version) - fifty fifty [edit audio]
why not - ghostface playa [edit audio]
montagem orquestra sinfnica - dj tenebroso [edit audio]
demons in my soul - scxr soul x sx1nxwy [edit audio]
into you - ariana grande (collab with @Earyzz [edit audio]
brazilian phonk mano - slowboy [edit audio]
pray for me - the weeknd, kendrick lamar [edit audio]
shameless - camila cabello [edit audio]
reminder - the weeknd [edit audio]
ghost! - phonk.me, kiixshi [edit audio]
lowkey vibe - beach weather [edit audio]
wake up!  - moondeity [edit audio]
collide x under the influence - justine skye, chris brown [edit audio]
rapture - interworld [edit audio]
tous les mmes - stromae [edit audio]
murder in my mind (ravens rock remix) - kordhell [edit audio]
hey, mickey! (oh mickey, you're so fine) - baby tate [edit audio]
devil eyes - zodvik [edit audio]
neon blade - moondeity [edit audio]
gigachad theme (phonk house version) - g3ox_em [edit audio]
after hours - the weeknd [edit audio]
Give It To Me (if you see us in the club) - ft. nelly furtado, justin timberlake [edit audio]
faded - alan walker [edit audio]
kill bill - sza [edit audio]
escapism - raye ft. 070 shake [edit audio]
i'm good - david guetta ft. bebe rexha (blue) [edit audio]
bloody mary (dum dum, da-di-da) - lady gaga [edit audio]
big boy (i need a big boy, give me a big boy) - sza [edit audio]
tukoh taka - nicki minaj, maluma, & myriam fares [edit audio]
where have you been x the hills - rihanna, the weekend [edit audio]
collide - justine skye  ft. tyga [edit audio]
calm down - rema, selena gomez [edit audio]
who is she x the perfect girl - i monster, mareux [edit audio]
who is she - i monster [edit audio]
i'm yours - isabel larosa [edit audio]
scopin - kordhell [edit audio]
la la la (brazil 2014) - shakira ft. carlinhos brown [edit audio]
bloody mary (I'll dance dance dance with my hands) - lady gaga [edit audio]
no (untouchable, untouchable) - meghan trainor [edit audio]
sing for the moment - eminem [edit audio]
worth nothing - twisted [edit audio]
superman - eminem [edit audio]
me gusta - dtf [edit audio]
on my own - darci [edit audio]
people you know - selena gomez [edit audio]
metamorphosis - interworld [edit audio]
cool kids - echosmith [edit audio] (collab with @YuNGFrizEdits)
mockingbird - eminem [edit audio]
ты и € - xcho [edit audio]
miss you - oliver tree & robin schulz [edit audio]
shadow - onimxru x smithmane [edit audio]
play with fire - sam tinnesz [edit audio]
wannabe - why mona [edit audio]
blinding lights - the weeknd (collab with @itsshadowedits) [edit audio]
unholy - sam smith ft. kim petras [edit audio]
the perfect girl - mareux [edit audio]
gangsta - kehlani [edit audio]
worth it (instrumental) - fifth harmony ft. kid ink [edit audio]
warning - mc orsen [edit audio]
shut down - blackpink [edit audio]
side to side - ariana grande ft. nicki minaj [edit audio]
bad girls - m.i.a [edit audio]
my ordinary life - the living tombstone [edit audio]
one kiss x stereo love - edward maya, dua lipa [edit audio]
mary on a cross - ghost [edit audio]
ele te bota soca soca - mc mazzie [edit audio]
starboy (stranger things remix) - the weeknd [edit audio]
nemesis - ryllz [edit audio]
under the influence x renegade - chris brown, aaryan shah [edit audio]
space cadet - metro boomin ft. gunna [edit audio]
my!lane Ц this feeling [edit audio]
pump it - black eyed peas [edit audio]
on the floor - jennifer lopez ft. pitbull [edit audio]
under the influence x i was never there - chris brown & the weeknd [edit audio]
pink venom - blackpink [edit audio]
safe and sound - capital cities [edit audio]
snap (sped up) - rosa linn [edit audio]
one kiss x i was never there - dua lipa & the weeknd [edit audio]
hey mama - david guetta ft. nicki minaj, bebe rexha & afrojack [edit audio]
starboy - the weeknd ft. daft punk [edit audio]
twilight - gravechill [edit audio]
double take - dhruv [edit audio]
under the influence - chris brown [edit audio]
stereo love - edward maya & vika jigulina [edit audio]
woo - rihanna [edit audio]
vendetta! - mupp x sadfriendd [edit audio]
midnight - playamane x nateki [edit audio]
draco - playboi carti [edit audio]
arabian nights - will smith [edit audio]
don't blame me (sped up) - taylor swift [edit audio]
it's you - ali gatie [edit audio]
overdo$e - pharmacist [edit audio]
everything black - unlike pluto [edit audio]
power (you're the man but i got the power) - little mix ft. stormzy [edit audio]
murder in my mind - kordhell [edit audio]
phonky town - playaphonk [edit audio]
hope - xxxtentacion [edit audio]
house of memories (sped up) - panic! at the disco [edit audio]
call out my name (guess i was just another pit stop) - the weeknd [edit audio]
shake pt. 2 - ishowspeed [edit audio]
paro (sped up) - nej' [edit audio]
shake - ishowspeed [edit audio]
on my way - alan walker, sabrina carpenter & farruko [edit audio]
looking at me - sabrina carpenter [edit audio]
1, 2, 3 (sped up) - sofia reyes ft. jason derulo & de la ghetto [edit audio]
fearless - lost sky ft. chris linton [edit audio]
left and right - charlie puth feat. jung kook [edit audio]
one kiss - calvin harris, dua lipa [edit audio]
bad boy - tungevaag, raaban [edit audio]
cold (baby tell me how did you get so cold) - maroon 5 ft. future [edit audio]
give me everything - pitbull ft. ne-yo, afrojack, nayer [edit audio]
I was never there (sped up) - the weeknd ft. gesaffelstein [edit audio]
swalla (sped up) - jason derulo ft. nikki minaj & ty dolla $ign [edit audio]
dandelions - ruth b. [edit audio]
running up that hill (a deal with god) - kate bush [edit audio]
i took a pill in ibiza (seeb remix) - mike posner [edit audio]
villain - k/da ft. madison beer, kim petras [edit audio]
woo (send for me) - rihanna [edit audio]
fake - the tech thieves [edit audio]
me too - meghan trainor [edit audio]
goumi (tiktok remix) - myriam fares [edit audio]
la la la - naughty boy ft. sam smith [edit audio]
set fire to the rain x the hills - adele, the weeknd [edit audio]
swim (sped up) - chase atlantic [edit audio]
save your tears - the weeknd ft. ariana grande [edit audio]
rockabye - clean bandit ft. anne marie & sean paul [edit audio]
i like me better (rnbass) - lauv [edit audio]
dusk till dawn x another love - zayn, sia & tom odell [edit audio]
loveeeeeee song (sped up) - rihanna ft. future [edit audio]
waka waka (ziggy & chick flix remix) - shakira [edit audio]
flashbacks x carol of the bells - craspore & lindsey stirling [edit audio]
rover (sped up) - s1mba ft. dtg [edit audio]
slow motion (sped up) - amaria bb [edit audio]
after dark - mr.kitty [edit audio]
daisy - ashnikko [edit audio] (collab with shadow edits)
harleys in hawaii (you and i) - katy perry [edit audio]
love story (sped up) - indila [edit audio]
middle of the night (japanese version) - elley duh (shayne orok cover) [edit audio]
heathens - twenty one pilots [edit audio]
wasted (huken x murkish) - juice wrld [edit audio]
she make it clap (freestyle) - adin ross ft. tory lanez [edit audio]
middle of the night - elley duh x joel sunny [edit audio]
praise god - kanye west [edit audio]
london view - tpl bm (otp) [edit audio]
gangsta's paradise - coolio feat. lv [edit audio]
grilling n****s - cupcakke [edit audio]
living life in the night - cheriimoya, sierra kidd [edit audio]
heat waves - glass animals x highcloud cover [edit audio]
doin' time - lana del rey [edit audio]
rave - dxrk - [edit audio]
la espada - eternal raijin [edit audio]
stereo love (spedup) - edward maya & vika jigulina [edit audio]
vegas (tiktok version) - joseline hernandez | i wanna ride i wanna ride [edit audio]
hard 2 face reality - justin bieber, poo bear, jay electronica [edit audio]
after dark x sweater weather - mr.kitty & the neighbourhood [edit audio]
touch it (tiktok remix) - busta rhymes [edit audio]
first woe - fdream [edit audio]
idfc x wasted - blackbear & juice wrld ft. lil uzi [edit audio]
stressed out - twenty one pilots [edit audio]
rockabye (shaked remix) - clean bandit ft. sean paul & anne-marie [edit audio]
lost in the fire - gesaffelstein & the weeknd [edit audio]
kawaii - tatarka [sped up + reverb]
stan x after dark - eminem ft. dido, mr.kitty [edit audio]
circus x poker face - britney spears, lady gaga [edit audio]
kawaii (sped up) - tatarka [edit audio]
love me back - trinidad cardona [edit audio]
often (kygo remix) - the weeknd [edit audio]
fairytale - alexander rybak [edit audio]
Edit audios that makes me want to edit on funimate
the hills - the weeknd [edit audio]
cool for the summer (sped up) - demi lovato [edit audio]
money rain (phonk remix) - vtornik [edit audio]
middle of the night - elley duh [slowed + reverb]
guy.exe - superfruit [edit audio]
hymn for the weekend - coldplay [edit audio]
mr. saxobeat (hi def remix) - alexandra stan [edit audio]
unforgettable - french montana ft. swae lee [edit audio]
chammak challo (ra one) - akon, hamsika iyer [edit audio]
gasoline - halsey [edit audio]
jungle - emma louise [edit audio]
yo voy (tiktok remix) - zion & lennox ft. daddy yankee [edit audio]
royalty x masquerade - egzod & maestro chives ft. neoni, siouxxie [edit audio]
bad blood - taylor swift ft. kendrick lamar [edit audio]
lean on - major lazer & dj snake (ft.m) [edit audio]
ps5 - salem ilese, tomorrow x together ft. alan walker [edit audio]
beautiful creature - miia [edit audio]
suave - el alfa [edit audio]
silhouette - pastel ghost [edit audio]
rockstar (crankdat remix) - post malone ft. 21 savage [edit audio]
boyfriend - dove cameron [edit audio]
light switch - charlie puth [edit audio]
dusk till dawn - zayn ft. sia [edit audio]
sahara - hensonn [edit audio]
without me - eminem [edit audio]
bum bum tam tam - mc fioti [edit audio]
another love - tom odell [edit audio]
gimme more - britney spears [edit audio]
go down deh - spice, sean paul, shaggy [edit audio]
mony so big - yeat [edit audio]
safari - serena [edit audio]
high enough - k.flay [edit audio]
poker face - lady gaga [edit audio]
tourner dans le vide - indila [edit audio]
lovely - billie eilish, khalid [edit audio]
slow down - chris linton & cadmium [edit audio]
la la la (k theory remix) - naughty boy ft. sam smith [edit audio]
judas - lady gaga [edit audio]
enemy x genius - imagine dragons, lsd [edit audio]
sexyback - justin timberlake ft. timbaland [edit audio]
danza kuduro - don omar ft. lucenzo [edit audio]
WARNING: [youtube] Failed to download m3u8 information: <urllib3.connection.HTTPSConnection object at 0x000002C2244F26B0>: Failed to resolve 'manifest.googlevideo.com' ([Errno 11002] getaddrinfo failed)
mujeriego - ryan castro [edit audio]
WARNING: [youtube] Failed to download m3u8 information: <urllib3.connection.HTTPSConnection object at 0x00000185459171F0>: Failed to resolve 'manifest.googlevideo.com' ([Errno 11002] getaddrinfo failed)
WARNING: [youtube] Failed to download m3u8 information: <urllib3.connection.HTTPSConnection object at 0x00000226180E5F90>: Failed to resolve 'manifest.googlevideo.com' ([Errno 11002] getaddrinfo failed)
WARNING: [youtube] Failed to download m3u8 information: <urllib3.connection.HTTPSConnection object at 0x00000251C04AAD70>: Failed to resolve 'manifest.googlevideo.com' ([Errno 11002] getaddrinfo failed)
WARNING: [youtube] Failed to download m3u8 information: <urllib3.connection.HTTPSConnection object at 0x000002A68B10A8F0>: Failed to resolve 'manifest.googlevideo.com' ([Errno 11002] getaddrinfo failed)
cheap thrills - sia ft. sean paul [edit audio]
middle of the night - elley duh [edit audio]
whatever it takes - imagine dragons [edit audio]
jenny (i wanna ruin our friendship) - studio killers [edit audio]
ghost - justin bieber [edit audio]
hayloft - mother mother [edit audio]
blow - ke$ha [edit audio]
7 rings - ariana grande [edit audio]
fed up - ghostemane [edit audio]
live another day - kordhell [edit audio]
toxic x pony - britney spears, ginuwine [edit audio]
misery x cpr - maroon 5, cupcakke [edit audio]
lambada - t-fest x scriptonite [edit audio]
pity party x control - melanie martinez, halsey [edit audio]
you right - doja cat, the weeknd [edit audio]
enemy x believer - imagine dragons x j.i.d [edit audio]
backstabber - ke$ha [edit audio]
stereo hearts x zaalima - gym class heroes ft. adam levine, raees [edit audio]
papaoutai - stromae [edit audio]
gangnam style - psy [edit audio]
one dance (baby i like your style) - drake ft. wizkid & kyla [edit audio]
paparazzi - kim dracula [edit audio]
16 shots - stefflon don [edit audio]
can't hold us (southend revolution remix) - macklemore & ryan lewis ft. ray dalton [edit audio]
skechers - dripreport [edit audio]
high school x love nwantiti - nicki minaj ft. lil wayne, ckay [edit audio]
material girl - saucy santana [edit audio]
rolling in the deep - adele [edit audio]
temperature - sean paul [edit audio]
kiss me more x bananza (belly dancer) - doja cat ft. sza, akon [edit audio]
all the things she said - t.a.t.u [edit audio]
toxic x discord x my ordinary life - boywithuke, the living tombstone [edit audio]
lucky (i'm so lucky lucky) - lucky twice [edit audio]
cpr x love game - cupcakke, lady gaga [edit audio]
infinity x runaway - jaymes young, aurora [edit audio]
enemy x heathens - imagine dragons, jid & twenty one pilots [edit audio]
stay - the kid laroi ft. justin bieber [edit audio]
enemy - imagine dragons, jid [edit audio]
dernire danse x the real slim shady - indila, eminem [edit audio]
no lie - sean paul ft. dua lipa [edit audio]
toxic x heathens - boywithuke, twenty one pilots [edit audio]
money x i like it - lisa, cardi b [edit audio]
toxic - 2wei [edit audio]
pope is a rockstar x bellyache - sales & billie eilish [edit audio]
discord - the living tombstone ft. eurobeat brony [edit audio]
jalebi baby x gta s.a - tesher [edit audio]
title - meghan trainor [edit audio]
telepata - kali uchis [edit audio]
cpr (instrumental) - cupcakke [edit audio]
tell em x miss the rage - cochise & trippie red ft. playboi carti [edit audio]
cpr - cupcakke [edit audio]
all time low - jon bellion [edit audio]
carol of the bells - lindsey stirling [edit audio]
la espada x how you like that - eternal raijin & blackpink [edit audio]
heat waves x safety net - glass animals & ariana grande ft. ty dolla $ign [edit audio]
pretty savage x masquerade - black pink & siouxxie [edit audio]
jalebi baby - tesher [edit audio]
love & war - yellow claw ft. yade lauren [edit audio]
satisfaction - benny benassi [edit audio]
tuesday - burak yeter ft. danelle sandoval [edit audio]
copines - aya nakamura [edit audio]
#brooklynbloodpop! - syko [edit audio]
comics - caravan palace [edit audio]
ladies and gentleman her x ainsi bas la vida - indila [edit audio]
one dance - drake ft. wizkid [edit audio]
such a wh*re - jvla [edit audio]
idfc (i'm only a fool for you) - blackbear [edit audio]
another love x infinity - tom odell & jaymes young [edit audio]
own brand freestyle - felixthe1st, dreya mac, finch fetti [edit audio]
infinity x fragile - jaymes young & kygo, labrinth [edit audio]
dynasty - miia [edit audio]
s&m - rihanna [edit audio]
all mine - plaza [edit audio]
whats the prob dog (let me think about it) - wisekids [edit audio]
nuestra cancin x praise god - monsieur perine x kanye west [edit audio]
infinity - jaymes young [edit audio]
temperature x bananza (belly dancer) - sean paul & akon [edit audio]
waka waka (this time for africa) - shakira [edit audio]
love nwantiti x habibi - ckay & dj gimi-o albanian remix [edit audio]
masquerade x my ordinary life - siouxxie & the living tombstone [edit audio]
sky - playboi carti [edit audio]
abcdefu - gayle [edit audio]
20 min - lil uzi vert [edit audio]
legends never die - league of legends ft. against the current [edit audio]
attention - charlie puth [edit audio]
levitating - dua lipa ft. dababy [edit audio]
this could be us - rae sremmurd [edit audio]
enemy - imagine dragons [edit audio]
afterlife (ark patrol remix) - xyl [edit audio]
hot2touch - felix jaehn, hight, alex aiono [edit audio]
gentleman - psy [edit audio]
WARNING: [youtube] Failed to download m3u8 information: <urllib3.connection.HTTPSConnection object at 0x000001B82490FCA0>: Failed to resolve 'manifest.googlevideo.com' ([Errno 11002] getaddrinfo failed)
whoopty - cj [edit audio]
WARNING: [youtube] Failed to download m3u8 information: <urllib3.connection.HTTPSConnection object at 0x0000020C54D2FDC0>: Failed to resolve 'manifest.googlevideo.com' ([Errno 11002] getaddrinfo failed)
WARNING: [youtube] Failed to download m3u8 information: <urllib3.connection.HTTPSConnection object at 0x0000020E1CFFFCA0>: Failed to resolve 'manifest.googlevideo.com' ([Errno 11002] getaddrinfo failed)
WARNING: [youtube] Failed to download m3u8 information: <urllib3.connection.HTTPSConnection object at 0x000002CCF1B03EB0>: Failed to resolve 'manifest.googlevideo.com' ([Errno 11002] getaddrinfo failed)
WARNING: [youtube] Failed to download m3u8 information: <urllib3.connection.HTTPSConnection object at 0x000001F63706FEE0>: Failed to resolve 'manifest.googlevideo.com' ([Errno 11002] getaddrinfo failed)
like that - doja cat [edit audio]
e.t. - katy perry ft. kanye west [edit audio]
boss b*tch - doja cat [edit audio]
feel something - bea miller [edit audio]
undress rehearsal - timeflies [edit audio]
ladies and gentleman her x camel by camel - sandy marton [edit audio]
toxic x discord - boywithuke & the living tombstone [edit audio]
ophelia - the lumineers [edit audio]
masquerade x miss the rage - siouxxie & trippie redd, playboi carti [edit audio]
careless whisper - george michael [edit audio]
lemonade - internet money ft. don toliver, gunna & nav [edit audio]
the search - nf [edit audio]
unstoppable - sia [edit audio]
pacify her - melanie martinez [edit audio]
the real slim shady - eminem [edit audio]
take you dancing - jason derulo [edit audio]
dick - starboi3 ft. doja cat [edit audio]
hot girl bummer - blackbear [edit audio]
heat waves - glass animals [edit audio]
diamonds - rihanna [edit audio]
rich boy x bring it back - payton moormeier & travis porter [edit audio]
solo - clean bandit ft. demi lovato [edit audio]
love nwantiti x idfc - ckay & blackbear [edit audio]
sad girlz luv money (remix) - amaarae, moliy, kali uchis [edit audio]
work from home - fifth harmony ft. ty dolla $ign [edit audio]
black out days (future islands remix) - phantogram [edit audio]
rich girl - gwen stefani ft. eve [edit audio]
streets - doja cat [edit audio]
rhinestone eyes - gorillaz [edit audio]
sweater weather - the neighbourhood [edit audio]
play date - melanie martinez [edit audio]
montero x my ordinary life - lil nas x & the living tombstone [edit audio]
hotel room service - pitbull [edit audio]
clarity (muffoxx edit) - zedd ft. foxes [edit audio]
habibi (albanian remix) - dj gimi-o [edit audio]
spooky scary skeletons (remix) - andrew gold, the living tombstone [edit audio]
eleanor rigby - cody fry [edit audio]
l.a.love - fergie [edit audio]
bring it back - travis porter [edit audio]
send my love - adele [edit audio]
counting stars - onerepublic [edit audio]
cake - melanie martinez [edit audio]
worth it - fifth harmony ft. kid ink [edit audio]
mi gente - j balvin & willy william [edit audio]
bumpy ride - mohombi [edit audio]
alors on danse - stromae [edit audio]
ainsi bas la vida - indila [edit audio]
poison - rita ora [edit audio]
i love you so - the walters [edit audio]
suffer with me - lue [edit audio]
chop chop slide - insane clown posse [edit audio]
tokyo (nya arigato) - leat'eq [edit audio]
sg (sexy girls) - dj snake, ozuna, megan thee stallion, lisa of blackpink [edit audio]
мо€ голова винтом (my head is spinning like a screw) - kostromin [edit audio]
love nwantiti (north african remix) - ckay, elgrandetoto [edit audio]
industry baby - lil nas x, jack harlow [edit audio]
somebody's watching me - rockwell [edit audio]
flashbacks - craspore [edit audio]
pocket rocket - cochise [edit audio]
dernire danse - indila [edit audio]
toxic - boywithuke [edit audio]
house of memories - panic! at the disco [edit audio]
no idea x body party - don toliver x ciara [edit audio]
she knows - j. cole [edit audio]
feel like god - playboi carti ( gazzzy remix ) prod. miyokibeats [edit audio]
hai domo - cao white [edit audio]
heart attack - demi lovato [edit audio]
and to those i love, thanks for sticking around (I'll be dead by dawn) - $uicideboy$ [edit audio]
idfc x soap - blackbear x melanie martinez [edit audio]
masquerade - siouxxie [edit audio]
soap - melanie martinez [edit audio]
need to know x desperado - doja cat x rihanna [edit audio]
industry baby x e.t. - lil nas x & katy perry [edit audio]
where have you been - rihanna [edit audio]
blood // water - grandson [edit audio]
montero (call me by your name) - lil nas x [edit audio]
just for me x #brooklynbloodpop - pinkpantheress x syko [edit audio]
dead to me - Sex whales & Fraxo [edit audio]
venom x idfc x soap - little simz x blackbear x melanie martinez [edit audio]
camel by camel - sandy marton [edit audio]
werkkk - tisakorean [edit audio]
close eyes - dvrst [edit audio]
miss wanna die - shinitai chan (jubyphonic) [edit audio]
savage x such a wh*re - megan thee stallion x jvla [edit audio]
venom x venom - little simz x eminem [edit audio]
see you again - charlie puth ft. wiz khalifa [edit audio]
takeaway - the chainsmokers, illenium ft. lennon stella [edit audio]
love nwantiti (tiktok remix) - ckay [edit audio]
rich boy - payton moormeier [edit audio]
world is spinning x rich boy - dmad x payton moormeier [edit audio]
WARNING: [youtube] Failed to download m3u8 information: <urllib3.connection.HTTPSConnection object at 0x000002178EC51B10>: Failed to resolve 'manifest.googlevideo.com' ([Errno 11002] getaddrinfo failed)
talking to the moon x arcade - bruno mars x duncan Laurence [edit audio]
WARNING: [youtube] Failed to download m3u8 information: <urllib3.connection.HTTPSConnection object at 0x000001D857CED900>: Failed to resolve 'manifest.googlevideo.com' ([Errno 11002] getaddrinfo failed)
WARNING: [youtube] Failed to download m3u8 information: <urllib3.connection.HTTPSConnection object at 0x000002136B7EDAB0>: Failed to resolve 'manifest.googlevideo.com' ([Errno 11002] getaddrinfo failed)
WARNING: [youtube] Failed to download m3u8 information: <urllib3.connection.HTTPSConnection object at 0x000002285E705A20>: Failed to resolve 'manifest.googlevideo.com' ([Errno 11002] getaddrinfo failed)
WARNING: [youtube] Failed to download m3u8 information: <urllib3.connection.HTTPSConnection object at 0x000002EBC26D6710>: Failed to resolve 'manifest.googlevideo.com' ([Errno 11002] getaddrinfo failed)
WARNING: [youtube] Failed to download m3u8 information: <urllib3.connection.HTTPSConnection object at 0x0000015D349E7970>: Failed to resolve 'manifest.googlevideo.com' ([Errno 11002] getaddrinfo failed)
money - lisa [edit audio]
WARNING: [youtube] Failed to download m3u8 information: <urllib3.connection.HTTPSConnection object at 0x0000020E47B7FCA0>: Failed to resolve 'manifest.googlevideo.com' ([Errno 11002] getaddrinfo failed)
WARNING: [youtube] Failed to download m3u8 information: <urllib3.connection.HTTPSConnection object at 0x000001BB844DBE80>: Failed to resolve 'manifest.googlevideo.com' ([Errno 11002] getaddrinfo failed)
WARNING: [youtube] Failed to download m3u8 information: <urllib3.connection.HTTPSConnection object at 0x000001CC8A763CA0>: Failed to resolve 'manifest.googlevideo.com' ([Errno 11002] getaddrinfo failed)
WARNING: [youtube] Failed to download m3u8 information: <urllib3.connection.HTTPSConnection object at 0x0000013E9455BCA0>: Failed to resolve 'manifest.googlevideo.com' ([Errno 11002] getaddrinfo failed)
criminal - britney spears [edit audio]
my universe - coldplay x bts [edit audio]
you are my high - dj snake [edit audio]
don't let me down - the chainsmokers ft. daya [edit audio]
kiss me more - doja cat ft. sza [edit audio]
say my name - david guetta ft. bebe rexha & j balvin [edit audio]
moves like jagger - maroon 5 ft. christina aguilera [edit audio]
lil nas x - thats what i want [edit audio]
thot shit x hell shell - megan thee stallion x yung nudy [edit audio]
havana - camila cabello ft. young thug [edit audio]
lalisa - lisa [edit audio]
oliver tree - life goes on [edit audio]
here (lucian remix) - alessia cara [edit audio]
dancin (krono remix) - aaron smith ft. luvli [edit audio]
streets x vacation bible school - doja cat x ayesha erotica [edit audio]
love nwantiti remix (ah ah ah) - ckay [edit audio]
montero (satan's extended) - lil nas x [edit audio]
sun goes down x middle - lil nas x & dj snake ft. bipolar [edit audio]
perfect - ed sheeran [edit audio]
payphone - maroon 5 ft. wiz khalifa [edit audio]
ola la - Kate linn [edit audio]
hero - cash cash ft. christina perri [edit audio]
gasolina - hatsune miku [edit audio]
get into it (yuh) - doja cat [edit audio]
woman (let me be your woman) - doja cat [edit audio]
hadal ahbek - issam alnajjar [edit audio]
toca toca - fly project [edit audio]
edamame - bbno$ & rich brian [edit audio]
dinero - trinidad cardona [edit audio]
you broke me first - tate mcrae [edit audio]
still falling for you - ellie goulding [edit audio]
touch it - kidi [edit audio]
beggin' - madcon [edit audio]
say you won't let go - james arthur [edit audio]
Inferno - sub urban & bella poarch [edit audio]
i wanna be your slave - mneskin [edit audio]
cognac queen - megan thee stallion [edit audio]
lily - alan walker ft. k-391 & emelie hollow [edit audio]
we don't talk anymore - charlie puth ft. selena gomez [edit audio]
touch it - busta rhymes | tiktok version [edit audio]
into your arms - witt lowry ft. ava max [edit audio]
stay - the kid laroi, justin bieber [edit audio]
@ my worst - blackbear (slowed+reverb)
@ my worst - blackbear [edit audio]
fashion week - blackbear [edit audio]
seorita - shawn mendes, camila Cabello [edit audio]
sweet but psycho - ava max [edit audio]
2 Phut Hon x Simple Dimple Pop It! Squish - phao x m&a [edit audio]
cold - maroon 5 ft. future [edit audio]
rules - doja cat [edit audio]
dessert x build a b*tch - dawin x bella poarch [edit audio]
need to know - doja cat [edit audio]
big and chunky - will.i.am [edit audio]
rasputin - boney m [edit audio]
industry baby - lil nas x ft. jack harlow [edit audio]
beggin' - mneskin [edit audio]
cheating on you - charlie puth [edit audio]
venom - eminem [edit audio]
low remix - flo rida & t-pain Tik Tok [edit audio]
bundles - kayla nicole ft. taylor girls [edit audio]
tutu - alma zarza [edit audio]
still be friends - g-eazy ft. tory lanez, tyga [edit audio]
grain in ear x black swan - mang chng x bts [edit audio]
simple dimple pop it! squish (симпл димпл поп ит сквиш) [edit audio]
am i wrong - nico & vinz [edit audio]
venom x my ordinary life - the living tombstone & ittle simz [edit audio]
mood - 24goldn ft. iann dior [edit audio]
say so - doja cat [edit audio]
foot fungus - ski mask the slump god x mask off - future [edit audio]
permission to dance x levitating - bts & dua lipa [edit audio]
geek'd up - bhad bhabie feat. lil baby [edit audio]
blood // water x montero (call me by your name) grandson - lil nas x [edit audio]
beggin' - mneskin x madcon [edit audio]
#brooklynbloodpop - syko [edit audio]
treat you better - shawn mendes [edit audio]
build a b*tch x this is what you came for -  bella poarch - calvin harris ft. rihanna [edit audio]
foot fungus x mood - ski mask the slump god - 24kgoldn ft. lann dior [edit audio]
true Colors - zedd kesha [edit audio]
the box - roddy ricch [edit audio]
happier - olivia rodrigo x ed sheeran x marshmello ft. bastille [edit audio]
happier - olivia rodrigo [edit audio]
stan - eminem ft. dido [edit audio]
r.i.p - croosh [edit audio]
look at me - xxxtentacion [edit audio]
arcade - duncan laurence [edit audio]
talking to the moon x it will rain - bruno mars [edit audio]
talking to the moon x hope - bruno mars x xxxtentacion [edit audio]
diamonds - rihanna (iccarus remix) [edit audio]
on the floor - jennifer lopez feat. pitbull [edit audio]
illijah - on my way (slowed)
on my way - illijah [edit audio]
mask off - future [edit audio]
stitches x come & go - shawn mendes x juice wrld ft. marshmello [edit audio]
stay with me - 1nonly x sell out - basco
my ordinary life x stereo hearts - the living tombstone x Gym Class Heroes Stereo Hearts
good 4 u - olivia rodrigo [edit audio]
how you like that - blackpink x mafia in the morning - itzy [edit audio]
tongue tied - cayman cline x the search - nf [edit audio]
idfc - blackbear | i'm only a fool for you [edit audio]
breather - mackenzie ziegler x play date - melanie martinez x build a b*tch - bella poarch [mashup]
Gryffin - Tie Me Down (slowed+reverb) ft. Elley Duh
the nights - aviici [edit audio]
runaway - aurora [edit audio]
DROP IT LIKE IT'S HOT X Astronaut in the Ocean X Snap Yo Fingers Quitezy
well met again - thefatrat laura brehm [edit audio]
Gryffin - Tie Me Down ft. Elley Duh (slowed+lyrics) Audio Edit
[1 HOUR] Foot Fungus x Mood Slowed Quitezy Mashup
Stay With Me (prod. nategoyard) x Mood
[1 HOUR] Foot Fungus x prison slowed (Quitezy Mashup)
Drivers license x Take me to church (8D Audio)
Foot Fungus x Mood Slowed (Lyrics) Quitezy Mashup
24kGoldn - Mood ft. Iann Dior (Slowed)
Faded x Stay With Me
Foot Fungus x Mood Slowed
Prison x Foot Fungus | 00:50 | Remix
Ngay Tho ( Phong Max remix ) - Freestyle dulu Bos
Hope xxtenations - Slowed Audio quitezy edit
Prism x Unstoppable (quitezy mashup)
Somebody that i used to know x Clarity Remix
Broken Hearts Mix Slowled (quitezy mashup)
Naxsy - Faded x 1nonly - Stay With Me (Quitezy mashup)
DROP IT LIKE IT_S HOT X Astronaut in the Ocean X Snap Yo Fingers (Quitezy mashup)
Flo Rida - Low x Gta San Andreas (Quitezy mashup)
hero! (brazilian phonk) - andromeda [edit audio] #quitezy #quitezyaudios #editaudios #audioforedits
funk do bounce (tiktok version) - ariis [edit audio] #audioeditaudio #editaudio
fainted - narvent [edit audio] #audioeditaudio #editaudio
